######
#   T#
#SB  #
#    #
######