######
#X   #
#BBBT#
#T   #
######