######
#S   #
#BB T#
#T   #
######