######
#S#T #
# #B #
#    #
######